DEU = "countries/Western Europe.txt" # Deutschland # 大ドイツ国
POL = "countries/Western Europe.txt" # Poland # ポーランド共和国
NFR = "countries/Western Europe.txt" # North_France # ノルトフランクライヒ国家弁務官区
FRA = "countries/Western Europe.txt" # France # フランス国
ESP = "countries/Western Europe.txt" # Espania # イベリア連邦
GBR = "countries/Western Europe.txt" # Great_Britain # イギリス連合
OST = "countries/Western Europe.txt" # Ostland # オストラント国家弁務官区
UKR = "countries/Western Europe.txt" # Ukraine # ウクライーネ国家弁務官区
KAV = "countries/Western Europe.txt" # Kavkaz # カウカーズース国家弁務官区
MOS = "countries/Western Europe.txt" # Moscowia # モスコーヴィエン国家弁務官区
CRM = "countries/Western Europe.txt" # Crimea # ドイツ領ゴーテンラント
NRU = "countries/Western Europe.txt" # North_Russia # 北ロシア・ソビエト共和国
RUS = "countries/Western Europe.txt" # Russian_Republic # ロシア共和国
LAR = "countries/Western Europe.txt" # Russian_Libaration_Army # ロシア国民解放軍
HRE = "countries/Western Europe.txt" # Holy_Russian_Empire # 神聖ロシア帝国
AUS = "countries/Western Europe.txt" # Austria # オーストリア帝国
MAG = "countries/Western Europe.txt" # Magyar # ハンガリー王国
ROM = "countries/Western Europe.txt" # Romania # ルーマニア王国
YSB = "countries/Western Europe.txt" # Yugoslav_Balkan # 南スラブ・バルカン連邦
GRE = "countries/Western Europe.txt" # Greece # ギリシャ共和国
ITA = "countries/Western Europe.txt" # Italy # イタリア共和国
SRI = "countries/Western Europe.txt" # Socialist_Republic_of_Italy # イタリア社会主義共和国
TRI = "countries/Western Europe.txt" # Trieste # トリエステ加速主義同盟
SIC = "countries/Western Europe.txt" # Sicily # 大シチリア国
NOR = "countries/Western Europe.txt" # Scandinavia # ドイツ領スカンジナビア
SWE = "countries/Western Europe.txt" # Sweden # スウェーデン王国
FIN = "countries/Western Europe.txt" # Finland # フィンランド連邦共和国
ALB = "countries/Western Europe.txt" # Albania # アルバニア
IRE = "countries/Western Europe.txt" # Ireland # アイルランド
BRI = "countries/Western Europe.txt" # Brittany # ブルターニュ・コミューン
SWI = "countries/Western Europe.txt" # Switzerland # スイス連邦
DEN = "countries/Western Europe.txt" # Denmark # デンマーク
SIB = "countries/Eastern Europe.txt" # Siberia # 天命シベリア
RRA = "countries/Eastern Europe.txt" # Russian_Relief_Area # ロシア救済連盟
RFA = "countries/Eastern Europe.txt" # Russian_Free_Area # ロシア自由地区
KAZ = "countries/Asia.txt" # Kazakh # カザフスタン・ソビエト共和国
TAJ = "countries/Asia.txt" # Tajik # タジキスタン共和国
TRK = "countries/Asia.txt" # Turkmen # トルクメニスタン連邦
PER = "countries/Middle East.txt" # Persia # ペルシア
IRQ = "countries/Middle East.txt" # Iraq # イラク統治機構
KHA = "countries/Middle East.txt" # Khaiyr # ハイール
OTT = "countries/Middle East.txt" # Ottoman # オスマン帝国
MUS = "countries/Middle East.txt" # Muscat  # マスカット
AFG = "countries/Middle East.txt" # Afghan  # アフガニスタン民主共和国
PAK = "countries/Asia.txt" # Pakistan # パキスタン独立軍
IND = "countries/Asia.txt" # India # インド連邦共和国
CCP = "countries/Asia.txt" # China_Communist_Party # 人民解放軍
CHI = "countries/Asia.txt" # China # 中華民国
SIA = "countries/Asia.txt" # Siam # シャム王国
DEA = "countries/Asia.txt" # Deuts_East_Asia # ドイツ領東アジア
AST = "countries/Commonwealth.txt" # Australia  # オーストラリア
NZL = "countries/Commonwealth.txt" # New_Zealand # ニュージーランド
PHI = "countries/Asia.txt" # Philippines # フィリピン
MON = "countries/Asia.txt" # Mongolia # 新モンゴル帝国
RSS = "countries/Eastern Europe.txt" # Russian_Socialist_Soviet # ロシア社会主義評議会
TAC = "countries/Asia.txt" # Thirteen_Army_Command # 第13軍司令部
RUE = "countries/Eastern Europe.txt" # Russian_Empire # ロシア帝国
IFE = "countries/Asia.txt" # Imperial_Far_East # 帝国極東保護区
IKP = "countries/Asia.txt" # Imperial_Kanto_Province # 帝国関東州
JPN = "countries/Asia.txt" # Japan # 日本人民共和国
TRI = "countries/Africa.txt" # Tripolitania # トリポリタニア自治政府
CYR = "countries/Africa.txt" # Cyrenaica # キレナイカ首長国
EGY = "countries/Middle East.txt" # Egypt # エジプト王国
ETH = "countries/Africa.txt" # Ethiopia  # エチオピア帝国
CHA = "countries/Africa.txt" # Chad # チャド共和国
CAF = "countries/Africa.txt" # Central_Africa # 中央アフリカ共和国
NIG = "countries/Africa.txt" # Nigeria # ナイジェリア
NGR = "countries/Africa.txt" # Niger # ニジェール反乱軍
MLI = "countries/Africa.txt" # Mali # マリ連邦
VOL = "countries/Africa.txt" # Haute_Volta # オートボルタ
BNN = "countries/Africa.txt" # Benin # ベナン
TOG = "countries/Africa.txt" # Togo # トーゴ
GHA = "countries/Africa.txt" # Ghana # ガーナ
WAF = "countries/Africa.txt" # West_Africa # 西アフリカ人民共和国連邦
SEN = "countries/Africa.txt" # Senegal # セネガル
MAF = "countries/Africa.txt" # Middle_Africa # ドイツ領ミッテルアフリカ
SAF = "countries/Africa.txt" # South_Africa # 南アフリカ連邦
USA = "countries/Western Europe.txt" # United_States_of_America # アメリカ合衆国
QUE = "countries/Western Europe.txt" # Quebec # ケベック共和国
MEX = "countries/South America.txt" # Mexico # メキシコ共和国
YUC = "countries/South America.txt" # Yucatan # ユカタン国
WIN = "countries/South America.txt" # West_Indies # 西インド諸島
CUB = "countries/South America.txt" # Cuba # キューバ
HAI = "countries/South America.txt" # Haiti # ハイチ
DOM = "countries/South America.txt" # Doimnican_Republic # ドミニカ共和国
UCA = "countries/South America.txt" # Union_of_Central_America # 中央アメリカ連合
COL = "countries/South America.txt" # Colombia # コロンビア
VEN = "countries/South America.txt" # Venezuela # ベネズエラ連邦
EQU = "countries/South America.txt" # Ecuador # エクアドル
PRU = "countries/South America.txt" # Peru # ペルー・コミューン
AMZ = "countries/South America.txt" # Amazon # アマゾンアナーキスト連盟
NBR = "countries/South America.txt" # Nazi_Brazil # ブラジルナチズム連合
FBR = "countries/South America.txt" # Free_Brazil # ブラジル自由地区
DBR = "countries/South America.txt" # Democratic_Brazil # ブラジル民主連合
PBR = "countries/South America.txt" # Peoples_Brazil # ブラジル人民共和国
UBR = "countries/South America.txt" # Union_of_Brazil # ブラジル連邦共和国
ABR = "countries/South America.txt" # Artistic_Brazil # 芸術・ブラジル国
BOA = "countries/South America.txt" # Bolivian_Army # ボリビア軍占領地域
BOL = "countries/South America.txt" # Bolivian # ボリビア
PRA = "countries/South America.txt" # Paraguay # パラグアイ
DST = "countries/South America.txt" # Deep_State # ディープステート
URU = "countries/South America.txt" # Uruguay # ウルグアイ
CHL = "countries/South America.txt" # Chile # チリ
ARG = "countries/South America.txt" # Argentina # アルゼンチン
